"filename", "language", "JavaScript", "CSS", "SCSS", "comment", "blank", "total"
"/Users/rhowell/mycode/floridivers/front-end/src/App.css", "CSS", 0, 23, 0, 6, 6, 35
"/Users/rhowell/mycode/floridivers/front-end/src/App.js", "JavaScript", 87, 0, 0, 0, 8, 95
"/Users/rhowell/mycode/floridivers/front-end/src/App.test.js", "JavaScript", 8, 0, 0, 0, 2, 10
"/Users/rhowell/mycode/floridivers/front-end/src/Components/About/About.css", "CSS", 0, 42, 0, 1, 2, 45
"/Users/rhowell/mycode/floridivers/front-end/src/Components/About/About.js", "JavaScript", 29, 0, 0, 0, 3, 32
"/Users/rhowell/mycode/floridivers/front-end/src/Components/About/About.scss", "SCSS", 0, 0, 49, 0, 10, 59
"/Users/rhowell/mycode/floridivers/front-end/src/Components/Admin/Admin.css", "CSS", 0, 109, 0, 1, 2, 112
"/Users/rhowell/mycode/floridivers/front-end/src/Components/Admin/Admin.js", "JavaScript", 108, 0, 0, 0, 12, 120
"/Users/rhowell/mycode/floridivers/front-end/src/Components/Admin/Admin.scss", "SCSS", 0, 0, 101, 4, 22, 127
"/Users/rhowell/mycode/floridivers/front-end/src/Components/Admin/Gallery/EditGallery.js", "JavaScript", 127, 0, 0, 4, 11, 142
"/Users/rhowell/mycode/floridivers/front-end/src/Components/Admin/Gallery/Gallery.css", "CSS", 0, 100, 0, 1, 19, 120
"/Users/rhowell/mycode/floridivers/front-end/src/Components/Admin/Gallery/Gallery.js", "JavaScript", 94, 0, 0, 0, 8, 102
"/Users/rhowell/mycode/floridivers/front-end/src/Components/Admin/Gallery/Gallery.scss", "SCSS", 0, 0, 85, 10, 16, 111
"/Users/rhowell/mycode/floridivers/front-end/src/Components/Admin/Learn/DivePackages.js", "JavaScript", 48, 0, 0, 0, 9, 57
"/Users/rhowell/mycode/floridivers/front-end/src/Components/Admin/Learn/LearnForm.js", "JavaScript", 108, 0, 0, 0, 7, 115
"/Users/rhowell/mycode/floridivers/front-end/src/Components/Admin/LoginForm.js", "JavaScript", 64, 0, 0, 1, 8, 73
"/Users/rhowell/mycode/floridivers/front-end/src/Components/Admin/NewsLetter/NewsLetter.css", "CSS", 0, 1, 0, 0, 0, 1
"/Users/rhowell/mycode/floridivers/front-end/src/Components/Admin/NewsLetter/NewsLetter.js", "JavaScript", 37, 0, 0, 0, 6, 43
"/Users/rhowell/mycode/floridivers/front-end/src/Components/Admin/NewsLetter/NewsLetter.scss", "SCSS", 0, 0, 0, 0, 1, 1
"/Users/rhowell/mycode/floridivers/front-end/src/Components/Backdrop/Backdrop.css", "CSS", 0, 9, 0, 0, 0, 9
"/Users/rhowell/mycode/floridivers/front-end/src/Components/Backdrop/Backdrop.js", "JavaScript", 4, 0, 0, 0, 3, 7
"/Users/rhowell/mycode/floridivers/front-end/src/Components/Calendar/Calendar.css", "CSS", 0, 13, 0, 1, 2, 16
"/Users/rhowell/mycode/floridivers/front-end/src/Components/Calendar/Calendar.js", "JavaScript", 20, 0, 0, 7, 4, 31
"/Users/rhowell/mycode/floridivers/front-end/src/Components/Calendar/Calendar.scss", "SCSS", 0, 0, 13, 0, 2, 15
"/Users/rhowell/mycode/floridivers/front-end/src/Components/Contact/Contact.css", "CSS", 0, 109, 0, 1, 3, 113
"/Users/rhowell/mycode/floridivers/front-end/src/Components/Contact/Contact.js", "JavaScript", 97, 0, 0, 0, 6, 103
"/Users/rhowell/mycode/floridivers/front-end/src/Components/Contact/Contact.scss", "SCSS", 0, 0, 105, 4, 19, 128
"/Users/rhowell/mycode/floridivers/front-end/src/Components/Crew/Crew.css", "CSS", 0, 73, 0, 1, 3, 77
"/Users/rhowell/mycode/floridivers/front-end/src/Components/Crew/Crew.js", "JavaScript", 53, 0, 0, 0, 4, 57
"/Users/rhowell/mycode/floridivers/front-end/src/Components/Crew/Crew.scss", "SCSS", 0, 0, 68, 3, 14, 85
"/Users/rhowell/mycode/floridivers/front-end/src/Components/Footer/Footer.css", "CSS", 0, 11, 0, 1, 1, 13
"/Users/rhowell/mycode/floridivers/front-end/src/Components/Footer/Footer.js", "JavaScript", 14, 0, 0, 0, 3, 17
"/Users/rhowell/mycode/floridivers/front-end/src/Components/Footer/Footer.scss", "SCSS", 0, 0, 11, 0, 1, 12
"/Users/rhowell/mycode/floridivers/front-end/src/Components/Gallery/Gallery.css", "CSS", 0, 33, 0, 0, 4, 37
"/Users/rhowell/mycode/floridivers/front-end/src/Components/Gallery/Gallery.js", "JavaScript", 49, 0, 0, 0, 6, 55
"/Users/rhowell/mycode/floridivers/front-end/src/Components/Header/Header.css", "CSS", 0, 144, 0, 1, 2, 147
"/Users/rhowell/mycode/floridivers/front-end/src/Components/Header/Header.js", "JavaScript", 87, 0, 0, 1, 10, 98
"/Users/rhowell/mycode/floridivers/front-end/src/Components/Header/Header.scss", "SCSS", 0, 0, 122, 7, 32, 161
"/Users/rhowell/mycode/floridivers/front-end/src/Components/Helpers/TextEditor.js", "JavaScript", 45, 0, 0, 0, 8, 53
"/Users/rhowell/mycode/floridivers/front-end/src/Components/Helpers/imgDrop/imgDrop.css", "CSS", 0, 64, 0, 1, 1, 66
"/Users/rhowell/mycode/floridivers/front-end/src/Components/Helpers/imgDrop/imgDrop.js", "JavaScript", 38, 0, 0, 41, 4, 83
"/Users/rhowell/mycode/floridivers/front-end/src/Components/Helpers/imgDrop/imgDrop.scss", "SCSS", 0, 0, 56, 0, 14, 70
"/Users/rhowell/mycode/floridivers/front-end/src/Components/Learn/Learn.css", "CSS", 0, 77, 0, 1, 2, 80
"/Users/rhowell/mycode/floridivers/front-end/src/Components/Learn/Learn.js", "JavaScript", 59, 0, 0, 0, 6, 65
"/Users/rhowell/mycode/floridivers/front-end/src/Components/Learn/Learn.scss", "SCSS", 0, 0, 77, 6, 13, 96
"/Users/rhowell/mycode/floridivers/front-end/src/Components/Main/Main.css", "CSS", 0, 92, 0, 1, 2, 95
"/Users/rhowell/mycode/floridivers/front-end/src/Components/Main/Main.js", "JavaScript", 34, 0, 0, 0, 2, 36
"/Users/rhowell/mycode/floridivers/front-end/src/Components/Main/Main.scss", "SCSS", 0, 0, 84, 3, 19, 106
"/Users/rhowell/mycode/floridivers/front-end/src/Components/Pages/Pages.css", "CSS", 0, 12, 0, 0, 4, 16
"/Users/rhowell/mycode/floridivers/front-end/src/Components/Pages/Pages.js", "JavaScript", 28, 0, 0, 0, 4, 32
"/Users/rhowell/mycode/floridivers/front-end/src/Components/mobileMenu/DrawerToggleButton.css", "CSS", 0, 20, 0, 0, 2, 22
"/Users/rhowell/mycode/floridivers/front-end/src/Components/mobileMenu/SideDrawer.css", "CSS", 0, 37, 0, 3, 6, 46
"/Users/rhowell/mycode/floridivers/front-end/src/Components/mobileMenu/Toolbar.css", "CSS", 0, 37, 0, 3, 8, 48
"/Users/rhowell/mycode/floridivers/front-end/src/Components/mobileMenu/drawerToggleButton.js", "JavaScript", 10, 0, 0, 0, 4, 14
"/Users/rhowell/mycode/floridivers/front-end/src/Components/mobileMenu/sideDrawer.js", "JavaScript", 39, 0, 0, 0, 3, 42
"/Users/rhowell/mycode/floridivers/front-end/src/Components/mobileMenu/toolbar.js", "JavaScript", 34, 0, 0, 2, 5, 41
"/Users/rhowell/mycode/floridivers/front-end/src/actions/index.js", "JavaScript", 103, 0, 0, 4, 19, 126
"/Users/rhowell/mycode/floridivers/front-end/src/index.css", "CSS", 0, 14, 0, 0, 4, 18
"/Users/rhowell/mycode/floridivers/front-end/src/index.js", "JavaScript", 19, 0, 0, 1, 3, 23
"/Users/rhowell/mycode/floridivers/front-end/src/reducers/admin.js", "JavaScript", 15, 0, 0, 0, 3, 18
"/Users/rhowell/mycode/floridivers/front-end/src/reducers/config.js", "JavaScript", 22, 0, 0, 1, 5, 28
"/Users/rhowell/mycode/floridivers/front-end/src/reducers/editGallery.js", "JavaScript", 20, 0, 0, 7, 3, 30
"/Users/rhowell/mycode/floridivers/front-end/src/reducers/formSubmission.js", "JavaScript", 20, 0, 0, 0, 4, 24
"/Users/rhowell/mycode/floridivers/front-end/src/reducers/galleries.js", "JavaScript", 14, 0, 0, 0, 3, 17
"/Users/rhowell/mycode/floridivers/front-end/src/reducers/gallery_uploader.js", "JavaScript", 32, 0, 0, 1, 6, 39
"/Users/rhowell/mycode/floridivers/front-end/src/reducers/index.js", "JavaScript", 25, 0, 0, 0, 3, 28
"/Users/rhowell/mycode/floridivers/front-end/src/reducers/learn.js", "JavaScript", 61, 0, 0, 0, 5, 66
"/Users/rhowell/mycode/floridivers/front-end/src/reducers/richText.js", "JavaScript", 19, 0, 0, 0, 3, 22
"/Users/rhowell/mycode/floridivers/front-end/src/reducers/spinner.js", "JavaScript", 18, 0, 0, 0, 3, 21
"/Users/rhowell/mycode/floridivers/front-end/src/reducers/user.js", "JavaScript", 20, 0, 0, 2, 3, 25
"/Users/rhowell/mycode/floridivers/front-end/src/setupTests.js", "JavaScript", 1, 0, 0, 4, 1, 6
"Total", "-", 1710, 1020, 771, 136, 446, 4083